# VoiceActress100
# VOICEACTRESS100
#
# This reading script file contains the text that provided under the CC-BY-SA 4.0 licence.
# I really respect and appreciate these awesome projects and the members!
#   - Voice Actress Corpus
#     - http://voice-statistics.github.io/
#   - JSUT corpus
#     - https://sites.google.com/site/shinnosuketakamichi/publication/jsut
#
VOICEACTRESS100_001	また東寺のように五大明王と呼ばれる主要な明王の中央に配されることも多い	マタトージノヨーニゴダイミョウオートヨバレルシュヨーナミョーオーノチューオーニハイサレルコトモオーイ
VOICEACTRESS100_002	ニューイングランド風は牛乳をベースとした白いクリームスープでありボストンクラムチャウダーとも呼ばれる	ニューイングランドフーワギューニューヲベーストシタシロイクリームスープデアリボストンクラムチャウダートモヨバレル
VOICEACTRESS100_003	コンピュータゲームのメーカーや業界団体などに関連する人物のカテゴリ	コンピュータゲームノメーカーヤギョーカイダンタイナドニカンレンスルジンブツノカテゴリ
VOICEACTRESS100_004	サービスマネージャー導入駅のため大井町駅から遠隔監視している	サービスマネージャードーニューエキノタメオーイマチエキカラエンカクカンシシテイル
VOICEACTRESS100_005	シルバーサーファー襲撃事件までにリチャーズはチーム名と共に国際的にスーパーヒーローおよび有名人として認知されている	シルバーサーファーシューゲキジケンマデニリチャーズワチームメイトトモニコクサイテキニスーパーヒーローオヨビユーメイジントシテニンチサレテイル
VOICEACTRESS100_006	ツュレンハルト領はヴュルテンベルク領に編入された	ツュレンハルトリョーワヴュルテンベルクリョーニヘンニューサレタ
VOICEACTRESS100_007	時間領域と空間領域で共通する処理手法はフィルタリングによる入力信号の強化である	ジカンリョーイキトクーカンリョーイキデキョーツースルショリシュホーワフィルタリングニヨルニューリョクシンゴーノキョーカデアル
VOICEACTRESS100_008	シャンチーの専業プロはチームから支払われる給料と対局費を主な収入としている	シャンチーノセンギョープロワチームカラシハラワレルキューリョートタイキョクヒヲオモナシューニュートシテイル
VOICEACTRESS100_009	また禰寝氏は中山王の治める琉球王国との交易にも参加した	マタネジメシワチューザンオーノオサメルリューキューオーコクトノコーエキニモサンカシタ
VOICEACTRESS100_010	スマートフォンからフィーチャーフォンまでマルチデバイスに対応	スマートフォンカラフィーチャーフォンマデマルチデバイスニタイオー
VOICEACTRESS100_011	軽妙洒脱なナレーションから情緒感溢れる語りまで幅広い表現力を持つ	ケイミョーシャダツナナレーションカラジョーチョカンアフレルカタリマデハバヒロイヒョーゲンリョクヲモツ
VOICEACTRESS100_012	構造は鋼製の単一アーチで橋脚は石積みである	コーゾーワハガネセイノタンイツアーチデキョーキャクワイシツミデアル
VOICEACTRESS100_013	そこへオーナーが新しいシェフとして腕利きのヒョヌクを招く	ソコエオーナーガアタラシイシェフトシテウデキキノヒョヌクヲマネク
VOICEACTRESS100_014	クィーンズアベニューアルファに所属している	クィーンズアベニューアルファニショゾクシテイル
VOICEACTRESS100_015	一方で漁業と商業でリャネス港は繁栄していた	イッポーデギョギョートショーギョーデリャネスコーワハンエイシテイタ
VOICEACTRESS100_016	このニューサウスウェールズ代表チームがワラビーズの中核となって行く	コノニューサウスウェールズダイヒョーチームガワラビーズノチューカクトナッテイク
VOICEACTRESS100_017	ただしギャンブル依存症の入院治療を行っている病院はわずかである	タダシギャンブルイゾンショーノニューインチリョーヲオコナッテイルビョーインワワズカデアル
VOICEACTRESS100_018	他のメジャーなディストリビューションに比べセキュリティー上の問題の修正が遅い場合もある	タノメジャーナディストリビューションニクラベセキュリティージョーノモンダイノシューセイガオソイバアイモアル
VOICEACTRESS100_019	ベルガートーア前のヴェディゲンウーファーパークには戦争と弾圧の犠牲者のための記念碑が建っている	ベルガートーアマエノヴェディゲンウーファーパークニワセンソートダンアツノギセイシャノタメノキネンヒガタッテイル
VOICEACTRESS100_020	全米パブリッシャーズ協会のベストストラテジーゲームオブザイヤーを日本人として受賞	ゼンベイパブリッシャーズキョーカイノベストストラテジーゲームオブザイヤーヲニホンジントシテジュショー
VOICEACTRESS100_021	痛みは点滴より鎮痛薬を静脈投与することで鎮痛を行う	イタミワテンテキヨリチンツーヤクヲジョーミャクトーヨスルコトデチンツーヲオコナウ
VOICEACTRESS100_022	このときに浮遊大陸プルヴァマにある中立国ビュエルバがある情報筋からバッシュ将軍の処刑と前王女アーシェの自害を発表	コノトキニフユータイリクプルヴァマニアルチューリツコクビュエルバガアルジョーホースジカラバッシュショーグンノショケイトゼンオージョアーシェノジガイヲハッピョー
VOICEACTRESS100_023	南西部ウォーレンはベイアーマンファームズとフィッツジェラルドの地区で構成される	ナンセイブウォーレンワベイアーマンファームズトフィッツジェラルドノチクデコーセイサレル
VOICEACTRESS100_024	このためプラズマ中のイオンや電子の持つ平均運動エネルギーを温度で表現することがある	コノタメプラズマチューノイオンヤデンシノモツヘイキンウンドーエネルギーヲオンドデヒョーゲンスルコトガアル
VOICEACTRESS100_025	その飄々とした人柄が老若男女に慕われている	ソノヒョーヒョートシタヒトガラガローニャクナンニョニシタワレテイル
VOICEACTRESS100_026	現在ニュージャージー州ムーアズタウンに住んでいる	ゲンザイニュージャージーシュームーアズタウンニスンデイル
VOICEACTRESS100_027	町域にあった三根山藩は長岡藩に米百俵を送ったことで有名	チョウイキニアッタミネヤマハンワナガオカハンニコメヒャッピョーヲオクッタコトデユーメイ
VOICEACTRESS100_028	このときペリメーデーはアムピクトリュオーンに同行してテーバイに来ていたリキュムニオスに妻としてあたえられた	コノトキペリメーデーワアムピクトリュオーンニドーコーシテテーバイニキテイタリキュムニオスニツマトシテアタエラレタ
VOICEACTRESS100_029	現在の滑走を目的としたスキーブーツは硬いプラスチックシェルと柔らかいインナーブーツからなる	ゲンザイノカッソーヲモクテキトシタスキーブーツワカタイプラスチックシェルトヤワラカイインナーブーツカラナル
VOICEACTRESS100_030	防氷ブーツは表面に張られたゴム製の薄い膜でできている	ボーヒョウブーツワヒョーメンニハラレタゴムセイノウスイマクデデキテイル
VOICEACTRESS100_031	後者の代表がウェッジウッドのジャスパーウェアである	コーシャノダイヒョーガウェッジウッドノジャスパーウェアデアル
VOICEACTRESS100_032	キー局が発信するニュースネットワーク名を冠したタイトルのニュース番組の中ではレギュラー放送が最も多い	キーキョクガハッシンスルニュースネットワークメイヲカンシタタイトルノニュースバングミノナカデワレギュラーホーソーガモットモオーイ
VOICEACTRESS100_033	芸能プロダクションアミューズのグループ企業	ゲイノープロダクションアミューズノグループキギョー
VOICEACTRESS100_034	長母音を省略してエリュシオンとも表記される	チョーボインヲショーリャクシテエリュシオントモヒョーキサレル
VOICEACTRESS100_035	森永のおいしい牛乳は濃い青色に牛乳瓶をあしらったデザインのパック牛乳である	モリナガノオイシーギュウニューワコイアオイロニギューニュービンヲアシラッタデザインノパックギューニューデアル
VOICEACTRESS100_036	番組冒頭を東京ムービー製作のアニメーションで表現する点も共通していた	バングミボウトーヲトーキョームービーセイサクノアニメーションデヒョーゲンスルテンモキョーツーシテイタ
VOICEACTRESS100_037	コミューンはセーヌ川とエソンヌ川の合流地点となっている	コミューンワセーヌガワトエソンヌガワノゴーリューチテントナッテイル
VOICEACTRESS100_038	同時に福井ミラクルエレファンツにコーチ兼任で入団することが発表された	ドージニフクイミラクルエレファンツニコーチケンニンデニューダンスルコトガハッピョーサレタ
VOICEACTRESS100_039	夫である小室が救急車を呼び都内病院に緊急搬送される	オットデアルコムロガキュウキュウシャヲヨビトナイビョーインニキンキューハンソーサレル
VOICEACTRESS100_040	ギレスピーはマッギーを通じてイネスと知り合った	ギレスピーワマッギーヲツージテイネストシリアッタ
VOICEACTRESS100_041	フォンテーヌブロー様式では寓意的な絵が漆喰のモールドに使われている	フォンテーヌブローヨーシキデワグーイテキナエガシックイノモールドニツカワレテイル
VOICEACTRESS100_042	祭神はヴィシュヌ派の聖人スワーミーナーラーヤン	サイジンワヴィシュヌハノセイジンスワーミーナーラーヤン
VOICEACTRESS100_043	ハーデースがペルセポネーに恋をしたのはアプロディーテーの策略であるとされている	ハーデースガペルセポネーニコイヲシタノワアプロディーテーノサクリャクデアルトサレテイル
VOICEACTRESS100_044	クウェーンバーンチャーンは小さなコミュニティーで農業や商業を中心に成り立っていたと考えられている	クウェーンバーンチャーンワチーサナコミュニティーデノーギョーヤショーギョーヲチューシンニナリタッテイタトカンガエラレテイル
VOICEACTRESS100_045	ヴェーザー自転車道やミューレンルートに従ったサイクリングツアーはペータースハーゲンを経由する	ヴェーザージテンシャドーヤミューレンルートニシタガッタサイクリングツアーワペータースハーゲンヲケイユスル
VOICEACTRESS100_046	フォーミュラカーは通常オープンホイールでシングルシーターである	フォーミュラカーワツージョーオープンホイールデシングルシーターデアル
VOICEACTRESS100_047	同日朝に大阪難波で出発セレモニーが開催され営業運転に充当された	ドージツアサニオーサカナンバデシュッパツセレモニーガカイサイサレエイギョーウンテンニジュートーサレタ
VOICEACTRESS100_048	そしてインデペンデント紙の読者投票で選ぶプレミアリーグ最優秀ゴールキーパーに選ばれた	ソシテインデペンデントシノドクシャトーヒョーデエラブプレミアリーグサイユーシューゴールキーパーニエラバレタ
VOICEACTRESS100_049	プレイヤーキャラクターは宮殿を占拠した邪悪なクリーチャーに遭遇する	プレイヤーキャラクターワキューデンヲセンキョシタジャアクナクリーチャーニソーグースル
VOICEACTRESS100_050	フィールドマーケティングは歴史的には一方通行のコミュニケーションツールとして考えられてきた	フィールドマーケティングワレキシテキニワイッポーツウコーノコミュニケーションツールトシテカンガエラレテキタ
VOICEACTRESS100_051	デビュー後の数年間はベビーフェイスとして本名で活動	デビューゴノスーネンカンワベビーフェイストシテホンミョーデカツドー
VOICEACTRESS100_052	学校や病院などの給食業務で栄養素を計算する上で重要な資料のひとつである	ガッコーヤビョーインナドノキューショクギョームデエイヨーソヲケイサンスルウエデジューヨーナシリョーノヒトツデアル
VOICEACTRESS100_053	当時あやしいわーるどに常駐していた擬古猫が空白にて発表	トージアヤシーワールドニジョーチューシテイタギコネコガクーハクニテハッピョー
VOICEACTRESS100_054	裕福なニューヨーカー達はグレーヴセンド競馬場やシープシェッドベイ競馬場などに集い海沿いの高級レストランやホテルを利用した	ユーフクナニューヨーカータチワグレーヴセンドケイバジョーヤシープシェッドベイケイバジョーナドニツドイウミゾイノコーキューレストランヤホテルヲリヨーシタ
VOICEACTRESS100_055	ウォリアーズミックスマーシャルアーツアカデミー所属	ウォリアーズミックスマーシャルアーツアカデミーショゾク
VOICEACTRESS100_056	ところがエリュシクトーンはニュムペーの制止も聞かずにデーメーテールの樫を切り倒した	トコロガエリュシクトーンワニュムペーノセイシモキカズニデーメーテールノカシヲキリタオシタ
VOICEACTRESS100_057	このジェシー役でステイモスはエミー賞にノミネートされたこともある	コノジェシーヤクデステイモスワエミーショーニノミネートサレタコトモアル
VOICEACTRESS100_058	スウェーデン移民の両親の許にマサチューセッツ州ケンブリッジにて生まれる	スウェーデンイミンノリョーシンノモトニマサチューセッツシューケンブリッジニテウマレル
VOICEACTRESS100_059	球宴のファン投票でも人気が偶像化していた長嶋茂雄に肉薄する	キューエンノファントウヒョーデモニンキガグーゾーカシテイタナガシマシゲオニニクハクスル
VOICEACTRESS100_060	母はピーターマリッツバーグの精神病院に入院しているときにベッシーを産む	ハハワピーターマリッツバーグノセイシンビョーインニニューインシテイルトキニベッシーヲウム
VOICEACTRESS100_061	ポイントガードからスモールフォワードまでこなせる総合力が高いユーティリティープレーヤーである	ポイントガードカラスモールフォワードマデコナセルソーゴーリョクガタカイユーティリティープレーヤーデアル
VOICEACTRESS100_062	グレッグはミシシッピ州アバディーンにあるオッドフェローズ墓地に埋葬されることになった	グレッグワミシシッピシューアバディーンニアルオッドフェローズボチニマイソーサレルコトニナッタ
VOICEACTRESS100_063	大当り終了後はグラディエーターチャンスに突入する	オーアタリシューリョーゴワグラディエーターチャンスニトツニュースル
VOICEACTRESS100_064	この菌による病気は灰色かび病と名づけられているものが多い	コノキンニヨルビョーキワハイーロカビビョートナズケラレテイルモノガオーイ
VOICEACTRESS100_065	レギュラーメンバーの顔写真をクリックした後にムービープレイヤー風に再生されるという特異な形式となっている	レギュラーメンバーノカオジャシンヲクリックシタノチニムービープレイヤーフーニサイセイサレルトユウトクイナケイシキトナッテイル
VOICEACTRESS100_066	肝臓への酸素供給は肝動脈と低圧系の門脈を介して行われている	カンゾーエノサンソキョーキューワカンドーミャクトテイアツケイノモンミャクヲカイシテオコナワレテイル
VOICEACTRESS100_067	デッドキーはタイプライターやコンピュータのキーボードにおける特殊な修飾キーである	デッドキーワタイプライターヤコンピュータノキーボードニオケルトクシュナシューショクキーデアル
VOICEACTRESS100_068	シャンシャン馬は鵜戸神宮へ参拝する新婚夫婦が乗っていた馬のこと	シャンシャンウマワウドジングーエサンパイスルシンコンフーフガノッテイタウマノコト
VOICEACTRESS100_069	ブルーリッジ山脈の源流からリッチモンドまで多くの早瀬や淵が釣りや急流くだりを楽しませてくれる	ブルーリッジサンミャクノゲンリューカラリッチモンドマデオークノハヤセヤフチガツリヤキューリュークダリヲタノシマセテクレル
VOICEACTRESS100_070	ボーハンはイーストマンらギャングのスピークイージーの上がりから賄賂を取っていたとも噂された	ボーハンワイーストマンラギャングノスピークイージーノアガリカラワイロヲトッテイタトモウワササレタ
VOICEACTRESS100_071	ペンシルベニア州フィラデルフィアの郊外ウィンウッドのランケナウ病院で生まれた	ペンシルベニアシューフィラデルフィアノコーガイウィンウッドノランケナウビョーインデウマレタ
VOICEACTRESS100_072	ブラッグはビューエル軍よりも劣勢だったためにこの機会を生かすことを躊躇した	ブラッグワビューエルグンヨリモレッセイダッタタメニコノキカイヲイカスコトヲチューチョシタ
VOICEACTRESS100_073	上院議員としてバーンウェルはカリフォルニア州の連邦加入に賛成した	ジョーインギーントシテバーンウェルワカリフォルニアシューノレンポーカニューニサンセイシタ
VOICEACTRESS100_074	レジェンドシリーズをベースにヨーフリー機構を備えたビューカメラ	レジェンドシリーズヲベースニヨーフリーキコーヲソナエタビューカメラ
VOICEACTRESS100_075	楽曲のセンターポジションはAKB48の高橋みなみが務めた	ガッキョクノセンターポジションワエーケービーフォーティエイトノタカハシミナミガツトメタ
VOICEACTRESS100_076	ディオニューソスの寵愛を受けるオイネウス王と妃アルタイアーの間にカリュドーンの王女として生を受けた	ディオニューソスノチョーアイヲウケルオイネウスオートキサキアルタイアーノアイダニカリュドーンノオージョトシテセイヲウケタ
VOICEACTRESS100_077	大西洋上の巡航高度から動力なしで地上へ滑空飛行し緊急着陸に成功した	タイセイヨウジョウノジュンコーコードカラドーリョクナシデチジョウエカックーヒコーシキンキューチャクリクニセイコーシタ
VOICEACTRESS100_078	表現行列の指標表を分子の対称性を表す点群の指標表を用いて既約表現へ分解する	ヒョーゲンギョーレツノシヒョーヒョーヲブンシノタイショーセイヲアラワステングンノシヒョーヒョーヲモチイテキヤクヒョーゲンエブンカイスル
VOICEACTRESS100_079	大洋漁業オーナーの中部謙吉の命を受けてプロ野球球団の大洋ホエールズに関わる	タイヨーギョギョーオーナーノナカベケンキチノメイヲウケテプロヤキューキューダンノタイヨーホエールズニカカワル
VOICEACTRESS100_080	かすかに聞こえてくる1931年版の讃美歌が次第に大きくなっていく	カスカニキコエテクルセンキュウヒャクサンジュウイチネンバンノサンビカガシダイニオーキクナッテイク
VOICEACTRESS100_081	モーイーデーン岩壁地域の上部はプラーサートプラウィハーン寺院遺跡へ繋がるタイ側参道に続いている	モーイーデーンガンペキチイキノジョーブワプラーサートプラウィハーンジインイセキエツナガルタイガワサンドーニツズイテイル
VOICEACTRESS100_082	カーミラ星と呼ばれている惑星から宇宙船に乗って地球に侵入した宇宙人	カーミラセイトヨバレテイルワクセイカラウチュウセンニノッテチキューニシンニューシタウチュージン
VOICEACTRESS100_083	ドッガーバンクはタラやニシンの漁獲量が多い重要な漁場である	ドッガーバンクワタラヤニシンノギョカクリョーガオーイジューヨーナリョーバデアル
VOICEACTRESS100_084	少年時代はロシア帝国チェルニーヒウ県プルィルークィ郡トロスチャヌィーツャ村で過ごした	ショーネンジダイワロシアテイコクチェルニーヒウケンプルィルークィグントロスチャヌィーツャムラデスゴシタ
VOICEACTRESS100_085	遺灰のほとんどはスウェーデン西海岸のブーヒュースレーン地方の小島にある漁村フヤルバッカ周辺の海に散骨された	イハイノホトンドワスウェーデンニシカイガンノブーヒュースレーンチホーノコジマニアルギョソンフヤルバッカシューヘンノウミニサンコツサレタ
VOICEACTRESS100_086	国境を越えて列車は改良された在来線に沿ってアーヘン中央駅に向かう	コッキョーヲコエテレッシャワカイリョーサレタザイライセンニソッテアーヘンチュウオウエキニムカウ
VOICEACTRESS100_087	福岡ダイエーホークスではなく長距離砲の補強を目指していた大阪近鉄バファローズからオファーを受けて入団	フクオカダイエーホークスデワナクチョーキョリホーノホキョーヲメザシテイタオーサカキンテツバファローズカラオファーヲウケテニューダン
VOICEACTRESS100_088	そこには百ドル札とアメリカに来いという短いメッセージだけだった	ソコニワヒャクドルサツトアメリカニコイトユウミジカイメッセージダケダッタ
VOICEACTRESS100_089	現在はバッハをモチーフとしたハープシコードの作曲家として記憶されている	ゲンザイワバッハヲモチーフトシタハープシコードノサッキョクカトシテキオクサレテイル
VOICEACTRESS100_090	戦闘服は両腕を露出し両脚がアンダースーツで覆われている	セントーフクワリョーウデヲロシュツシリョーキャクガアンダースーツデオオワレテイル
VOICEACTRESS100_091	同母姉にスウェーデン王妃ジョゼフィーヌがいる	ドーボシニスウェーデンオーヒジョゼフィーヌガイル
VOICEACTRESS100_092	紫外線は表面エネルギーの小さいポリマーを接着する際の前処理に利用される	シガイセンワヒョーメンエネルギーノチーサイポリマーヲセッチャクスルサイノマエショリニリヨーサレル
VOICEACTRESS100_093	自身のページでメッセージや公開コメントを通してレビューを投稿したユーザーとコミュニケーションを取ることが可能である	ジシンノページデメッセージヤコーカイコメントヲトーシテレビューヲトーコーシタユーザートコミュニケーションヲトルコトガカノーデアル
VOICEACTRESS100_094	若き日の反逆ゆえに宇宙の中央を追放されて惑星地球にやってきた主人公ベルゼバブが宇宙船カルナークのなかで孫に語る壮大な物語	ワカキヒノハンギャクユエニウチューノチューオーヲツイホーサレテワクセイチキューニヤッテキタシュジンコーベルゼバブガウチュウセンカルナークノナカデマゴニカタルソーダイナモノガタリ
VOICEACTRESS100_095	ジャガーとは対照的にボディービルダーを髣髴とさせるマッチョな体育会系の外見が特徴	ジャガートワタイショーテキニボディービルダーヲホーフツトサセルマッチョナタイークカイケイノガイケンガトクチョー
VOICEACTRESS100_096	ペンシルベニア州ピッツバーグのアレゲーニー高校を卒業しカリフォルニア大学バークレー校に入学	ペンシルベニアシューピッツバーグノアレゲーニーコーコーヲソツギョーシカリフォルニアダイガクバークレーコウニニュウガク
VOICEACTRESS100_097	この概念の導入によって様々なバリエーションの流体のコンピューターシミュレーションが高い精度で可能となった	コノガイネンノドーニューニヨッテサマザマナバリエーションノリュータイノコンピューターシミュレーションガタカイセイドデカノートナッタ
VOICEACTRESS100_098	乾ドックに入渠してオーバーホールすべきかどうかパフォーマンスがチェックされた	カンドックニニューキョシテオーバーホールスベキカドーカパフォーマンスガチェックサレタ
VOICEACTRESS100_099	デビューウェイトはスーパーバンタム級ではなくフェザー級だった	デビューウェイトワスーパーバンタムキューデワナクフェザーキューダッタ
VOICEACTRESS100_100	アーリーは降雨の中を南のバージニア州ウィンチェスター近くのフィッシャーズヒルまで軍を退いた	アーリーワコーウノナカヲミナミノバージニアシューウィンチェスターチカクノフィッシャーズヒルマデグンヲシリゾイタ
